7 8
......bb
.....bb.
....bb..
...bb...
..bb....
.bb.....
bb......
......*L
.....**.
....**..
...**...
..**....
.**.....
**......
1
5