9 9
..rgrgr..
..g.g.g..
rgrgbgrgr
g.g.g.g.g
rgbgrgbgr
g.g.g.g.g
rgrgbgrgr
..g.g.g..
..rgrgr..
...*.*...
..*...*..
.*.....*.
*...*...*
...*L*...
*...*...*
.*.....*.
..*...*..
...*.*...
1
3