9 9
RRRRRRRRR
BBBBBBBBB
BBBBBBBBB
BBBBBBBBB
BBBBBBBBB
BBBBBBBBB
BBBBBBBBB
BBBBBBBBB
GGGGGGGGG
*........
U........
.........
.........
.........
.........
.........
.........
........*
1
8
