8 8
......g.
gbbbbbb.
.b....b.
.bbbr.b.
.g.b.rb.
...b.bbg
...bbbg.
...g....
......*.
*.......
.D......
....*...
.*...*..
.......*
......*.
...*....
4
6 2 2 2