8 8
gggggb..
.rgggrgb
.g.bgr.g
.g.g...g
rrgbgggb
gg.g.grg
gbggr.bb
rggrr...
R...*...
..*....*
........
.*......
.....*..
.*...*..
*..*..*.
....*...
1
4